111111111
1P00CC001
1000000E1
111111111
