111111111111111111
1000P0000111100011
1000000C0C01C10001
100010000000000001
10001E010000010001
100011100010000001
111111111111111111
