111111111111111
10P0000E000C001
111111111111111
