11111111111111
10P0E00C010011
10000000000001
10000000000001
11111111111111
10000000000001
10000000000001
11111111111111
